FFFFFFFFFFFFFF000000
FFFFFFFFFFFFFF000000
000###00000000###000
000#S#0PFFFFFF#B#000
000#S#00000000#B#000
000###00000000###000
FFFFFFFFFFFFFF000000
FFFFFFFFFFFFFF000000
00#FFFFFFFFFFFFFF#00
00#FFFFFFFFFFFFFF#00
00##000000000000##00
000#000000000000#000
000##0B000S0000##000
0000############0000
FFFFFFFFFFFFFF000000
