00000000000000000000
00000000000000000000
000###00000000###000
000#0#0PFFFFFF#0#000
000#0#00000000#0#000
000###00000000###000
00000000000000000000
00000000000000000000
00#00000000000000#00
00#00000000000000#00
00##000000000000##00
000#000000000000#000
000##0B000S0000##000
0000############0000
00000000000000000000
