####################
#FF#0F0F0F0F0F0F0F0#
#FP#F0F0F0F0F0F0F0F#
##0#################
##0#000#000#000#0B##
##0#0#0#0#0#0#0#0###
##0#0#0#0#0#0#0#0###
##0#0#0#0#0#0#0#0###
##0S0#000#000#000###
####################